11111111111111111111111111111111
10001000001000010000C10011111011
10000000000000000000000010000001
10000000000000000000000P1E000001
100000C0000000000000000011000011
10000000000000000000000000000001
10000000000000000000000C00000001
100C1000100C1C000000000000000101
11111111111111111111111111111111
